+----------------------------+
|                            |
| #    #  ####  ####  #    # |
| #  ###              ###  # |
|             ##             |
|##  #####  ######  #####  ##|
|#   #                  #   #|
|#   #   #  ######  #   #   #|
|#   #  ##    ##    ##  #   #|
|#                          #|
|#########  ######  #########|
|                            |
| #  #   ############   #  # |
| #  #        #         #  # |
| #  #   ############   #  # |
|                            |
| #######            ####### |
| #          ###           # |
|            # #             |
+----------------------------+