+----------------------------++------------------+
|                            ||                  |
| #    #  ####  ####  #    # || -> SCOREBOARD <- |
| #  ###              ###  # ||    ^ ^ ^ ^ ^     |
|             ##             ||                  |
|##  #####  ######  #####  ##||                  |
|#   #                  #   #||                  |
|#   #   #  ######  #   #   #||                  |
|#   #  ##    ##    ##  #   #||                  |
|#                          #||                  |
|#########  ######  #########||                  |
|                            ||                  |
| #  #   #### # #####   #  # ||                  |
| #  #        #         #  # ||                  |
| #  #   #### # #####   #  # ||                  |
|                            ||                  |
| #######            ####### ||                  |
| #          ###           # ||                  |
|            # #             ||                  |
+----------------------------++------------------+