##############################
#                            #
# #    #  ####  ####  #    # #
# #  ###              ###  # #
#             ##             #
###  #####  ######  #####  ###
##   #                  #   ##
##   #   #  ######  #   #   ##
##   #  ##    ##    ##  #   ##
##                          ##
##########  ######  ##########
#                            #
# #  #   #### # #####   #  # #
# #  #        #         #  # #
# #  #   #### # #####   #  # #
#                            #
# #######            ####### #
# #          ###           # #
#            # #             #
##############################