##############################+------------------+
#                            #|                  |
# #    #  ####  ####  #    # #|    SCOREBOARD    |
# #  ###              ###  # #|                  |
#             ##             #|                  |
###  #####  ######  #####  ###|                  |
##   #                  #   ##|                  |
##   #   #  ######  #   #   ##|                  |
##   #  ##    ##    ##  #   ##|                  |
##                          ##|                  |
##########  ######  ##########|                  |
#                            #|                  |
# #  #   #### # #####   #  # #|                  |
# #  #        #         #  # #|                  |
# #  #   #### # #####   #  # #|                  |
#                            #|                  |
# #######            ####### #|                  |
# #          ###           # #|                  |
#              #             #|                  |
##############################+------------------+