##############################
#          #      #          #
# #    #  ####  ####  #    # #
# #  ###              ###  # #
#                            #
###  #  ##  ##  ##  ##  #  ###
##   #                  #   ##
##   #   #  ##  ##  #   #   ##
##   #  ##          ##  #   ##
##                          ##
##  ##  ##  ######  ##  ##  ##
#                            #
# #  #   #  # # #  ##   #  # #
# #  #        #         #  # #
# #  #   #  # # #  ##   #  # #
#                            #
# ###  ##            ##  ### #
# #          # #           # #
#                            #
##############################